80
30
~~~~~~~~~~~~~~~~~~~~~~~~~~~~~~~~~~~~~~~~~~~~~~~~~~~~~~~~~~~~~~~~~~~~~~~~~~~~~~~~
~~~~~~~~~~~~~~~~~~~~~~~~~~~~~~~~~~~~~~~~~~~~~~~~~~~~~~~~~~~~~~~~~~~~~~~~~~~~~~~~
~~~~~~~~~~~~~~~~~~~~~~~~~~~~~~~~~~~~~~~~~~~~~~~~~~~~~~~~~~~~~~~~~~~~~~~~~~~~~~~~
~~~~~~~~~~~~~~~~~~~~~~~~~~~~~~~~~~~~~~~~~~~~~~~~~~~~~~~~~~~~~~~~~~~~~~~~~~~~~~~~
~~~~~~~~~~~~""""""""""""""""""""""""""""""""""""""""""""""""""""~~~~~~~~~~~~~~~~
~~~~~~~~~~~~"""""""""%%%%%%%%%%"""""""""""""""""""""""""""""""""~~~~~~~~~~~~~~~~
~~~~~~~~~~~~"""""""""%%%%%%%%%%"""""""""""""""""""""""""""""""""~~~~~~~~~~~~~~~~
~~~~~~~~~~~~"""""""""%%%%%%%%%%"""""""""""""""""""""""""""""""""~~~~~~~~~~~~~~~~
~~~~~~~~~~~~"""""""""""""""""""""""^""""""""""""""""""""""""""""~~~~~~~~~~~~~~~~
~~~~~~~~~~~~"""""""""""""""""""""""^"^^"""""""""""""""""""""""""~~~~~~~~~~~~~~~~
~~~~~~~~~~~~""""""""""""""""""""""""^^^"""""""""""""""""""""""""~~~~~~~~~~~~~~~~
~~~~~~~~~~~~""""""""""""""""""""""""^^^"""""""""""""""""""""""""~~~~~~~~~~~~~~~~
~~~~~~~~~~~~""""╬╬╬╬╬╬╬╬╬╬╬╬╬╬╬╬╬"""^^^""""""╬╬╬╬╬╬╬╬╬╬╬╬╬╬╬""""~~~~~~~~~~~~~~~~
~~~~~~~~~~~~""""""""""""""""""""""""^^^""""""""""""""╬""""""""""~~~~~~~~~~~~~~~~
~~~~~~~~~~~~""""""""""""""""""""""""^^^""""""""""""""╬""""""""""~~~~~~~~~~~~~~~~
~~~~~~~~~~~~""""""""""""""""""""""""^^^""""""""""""""╬""""""""""~~~~~~~~~~~~~~~~
~~~~~~~~~~~~""""""""""""""""""""""""^^^"""""""""""""""""""""""""~~~~~~~~~~~~~~~~
~~~~~~~~~~~~"""""""""""""""""""""""""^^"""""""""""""""""""""""""~~~~~~~~~~~~~~~~
~~~~~~~~~~~~"""""""""""""""""""""""""^^"""""""""""""""""""""""""~~~~~~~~~~~~~~~~
~~~~~~~~~~~~""""""""""""""""""""""""""""""""%%%%%%%%""""""""""""~~~~~~~~~~~~~~~~
~~~~~~~~~~~~""""""""""""""""""""""""""""""""%%%%%%%%""""""""""""~~~~~~~~~~~~~~~~
~~~~~~~~~~~~""""""""""""""""""""""""""""""""%%%%%%%%""""""""""""~~~~~~~~~~~~~~~~
~~~~~~~~~~~~""""""""""""""""""""""""""""""""%%%%%%%%""""""""""""~~~~~~~~~~~~~~~~
~~~~~~~~~~~~""""""""""""""""""""""""""""""""""""""""""""""""""""~~~~~~~~~~~~~~~~
~~~~~~~~~~~~~~~~~~~~~~~~~~~~~~~~~~~~~~~~~~~~~~~~~~~~~~~~~~~~~~~~~~~~~~~~~~~~~~~~
~~~~~~~~~~~~~~~~~~~~~~~~~~~~~~~~~~~~~~~~~~~~~~~~~~~~~~~~~~~~~~~~~~~~~~~~~~~~~~~~
~~~~~~~~~~~~~~~~~~~~~~~~~~~~~~~~~~~~~~~~~~~~~~~~~~~~~~~~~~~~~~~~~~~~~~~~~~~~~~~~
~~~~~~~~~~~~~~~~~~~~~~~~~~~~~~~~~~~~~~~~~~~~~~~~~~~~~~~~~~~~~~~~~~~~~~~~~~~~~~~~
~~~~~~~~~~~~~~~~~~~~~~~~~~~~~~~~~~~~~~~~~~~~~~~~~~~~~~~~~~~~~~~~~~~~~~~~~~~~~~~~
~~~~~~~~~~~~~~~~~~~~~~~~~~~~~~~~~~~~~~~~~~~~~~~~~~~~~~~~~~~~~~~~~~~~~~~~~~~~~~~~

2
................................................................................
................................................................................
................................................................................
................................................................................
................................................................................
................................................................................
................................................................................
................................................................................
................................................................................
....................$...........................................................
................................................................................
................................................................................
............*##@........$.......................................................
................................................................................
................................................................................
................................................................................
................................................................................
........................$.......................................................
...................$............................................................
................................................................................
................................................................................
................................................................................
................................................................................
................................................................................
................................................................................
................................................................................
................................................................................
................................................................................
................................................................................

................................................................................
................................................................................
................................................................................
................................................................................
................................................................................
................................................................................
................................................................................
..........................................................$.....................
................................................................................
...................................................$............................
................................................................................
................................................................................
................................................................................
............................................................@##*................
................................................................................
...................................................$............................
................................................................................
.......................................................$........................
................................................................................
................................................................................
................................................................................
................................................................................
................................................................................
................................................................................
................................................................................
................................................................................
................................................................................
................................................................................
................................................................................

